2;0;2;0;2;0;2;0;2;0;2
0;2;0;2;0;2;0;2;0;2;0
2;0;2;0;2;4;2;0;2;0;2
0;2;0;2;0;2;0;2;0;2;0
2;0;2;0;2;0;2;0;2;0;2